"filename", "language", "Java", "Java Properties", "comment", "blank", "total"
"c:\Serious Project\Programing Studio 1\terrascope-backend\src\main\java\com\xuanduy\terrascope\Config.java", "Java", 19, 0, 0, 3, 22
"c:\Serious Project\Programing Studio 1\terrascope-backend\src\main\java\com\xuanduy\terrascope\TerrascopeApplication.java", "Java", 9, 0, 0, 5, 14
"c:\Serious Project\Programing Studio 1\terrascope-backend\src\main\java\com\xuanduy\terrascope\controller\CityController.java", "Java", 60, 0, 0, 11, 71
"c:\Serious Project\Programing Studio 1\terrascope-backend\src\main\java\com\xuanduy\terrascope\controller\CountryController.java", "Java", 88, 0, 0, 17, 105
"c:\Serious Project\Programing Studio 1\terrascope-backend\src\main\java\com\xuanduy\terrascope\controller\GlobalController.java", "Java", 18, 0, 0, 5, 23
"c:\Serious Project\Programing Studio 1\terrascope-backend\src\main\java\com\xuanduy\terrascope\controller\StateController.java", "Java", 58, 0, 0, 13, 71
"c:\Serious Project\Programing Studio 1\terrascope-backend\src\main\java\com\xuanduy\terrascope\dto\city\request\CityRequestDTO.java", "Java", 18, 0, 0, 7, 25
"c:\Serious Project\Programing Studio 1\terrascope-backend\src\main\java\com\xuanduy\terrascope\dto\city\respond\AverageValueOfTemperatureCityRecordDTO.java", "Java", 75, 0, 0, 26, 101
"c:\Serious Project\Programing Studio 1\terrascope-backend\src\main\java\com\xuanduy\terrascope\dto\city\respond\CityDTO.java", "Java", 38, 0, 0, 12, 50
"c:\Serious Project\Programing Studio 1\terrascope-backend\src\main\java\com\xuanduy\terrascope\dto\city\respond\CityDataWithinPeriodDTO.java", "Java", 25, 0, 0, 10, 35
"c:\Serious Project\Programing Studio 1\terrascope-backend\src\main\java\com\xuanduy\terrascope\dto\city\respond\SimilarPeriodCityRecordDTO.java", "Java", 90, 0, 0, 30, 120
"c:\Serious Project\Programing Studio 1\terrascope-backend\src\main\java\com\xuanduy\terrascope\dto\city\respond\TemperatureChangeCityRecordDTO.java", "Java", 107, 0, 0, 34, 141
"c:\Serious Project\Programing Studio 1\terrascope-backend\src\main\java\com\xuanduy\terrascope\dto\country\request\CountryRequestDTO.java", "Java", 24, 0, 0, 8, 32
"c:\Serious Project\Programing Studio 1\terrascope-backend\src\main\java\com\xuanduy\terrascope\dto\country\respond\AverageValueOfTemperatureCountryRecordDTO.java", "Java", 54, 0, 0, 21, 75
"c:\Serious Project\Programing Studio 1\terrascope-backend\src\main\java\com\xuanduy\terrascope\dto\country\respond\CountryDataWithinPeriodDTO.java", "Java", 26, 0, 0, 9, 35
"c:\Serious Project\Programing Studio 1\terrascope-backend\src\main\java\com\xuanduy\terrascope\dto\country\respond\CountryRecordDTO.java", "Java", 45, 0, 0, 14, 59
"c:\Serious Project\Programing Studio 1\terrascope-backend\src\main\java\com\xuanduy\terrascope\dto\country\respond\RawAndPercentageChangeCountryRecordDTO.java", "Java", 106, 0, 0, 35, 141
"c:\Serious Project\Programing Studio 1\terrascope-backend\src\main\java\com\xuanduy\terrascope\dto\country\respond\SimilarPeriodCountryRecordDTO.java", "Java", 66, 0, 0, 20, 86
"c:\Serious Project\Programing Studio 1\terrascope-backend\src\main\java\com\xuanduy\terrascope\dto\global\respond\RawAndPercentageChangeGlobalRecordDTO.java", "Java", 73, 0, 0, 22, 95
"c:\Serious Project\Programing Studio 1\terrascope-backend\src\main\java\com\xuanduy\terrascope\dto\state\request\StateRequestDTO.java", "Java", 24, 0, 0, 8, 32
"c:\Serious Project\Programing Studio 1\terrascope-backend\src\main\java\com\xuanduy\terrascope\dto\state\respond\AverageValueOfTemperatureStateRecordDTO.java", "Java", 59, 0, 0, 19, 78
"c:\Serious Project\Programing Studio 1\terrascope-backend\src\main\java\com\xuanduy\terrascope\dto\state\respond\RawAndPercentageChangeStateRecordDTO.java", "Java", 68, 0, 0, 20, 88
"c:\Serious Project\Programing Studio 1\terrascope-backend\src\main\java\com\xuanduy\terrascope\dto\state\respond\SimilarPeriodStateRecordDTO.java", "Java", 74, 0, 0, 22, 96
"c:\Serious Project\Programing Studio 1\terrascope-backend\src\main\java\com\xuanduy\terrascope\dto\state\respond\StateDTO.java", "Java", 24, 0, 0, 8, 32
"c:\Serious Project\Programing Studio 1\terrascope-backend\src\main\java\com\xuanduy\terrascope\dto\state\respond\TemperatureChangeStateRecordDTO.java", "Java", 93, 0, 0, 32, 125
"c:\Serious Project\Programing Studio 1\terrascope-backend\src\main\java\com\xuanduy\terrascope\dto\util\request\periodRequestDTO.java", "Java", 17, 0, 0, 6, 23
"c:\Serious Project\Programing Studio 1\terrascope-backend\src\main\java\com\xuanduy\terrascope\dto\util\respond\YearRangeDTO.java", "Java", 17, 0, 0, 6, 23
"c:\Serious Project\Programing Studio 1\terrascope-backend\src\main\java\com\xuanduy\terrascope\model\Country.java", "Java", 24, 0, 1, 7, 32
"c:\Serious Project\Programing Studio 1\terrascope-backend\src\main\java\com\xuanduy\terrascope\repository\CityRepository.java", "Java", 480, 0, 0, 39, 519
"c:\Serious Project\Programing Studio 1\terrascope-backend\src\main\java\com\xuanduy\terrascope\repository\CountryRepository.java", "Java", 497, 0, 0, 50, 547
"c:\Serious Project\Programing Studio 1\terrascope-backend\src\main\java\com\xuanduy\terrascope\repository\GlobalRepository.java", "Java", 70, 0, 0, 10, 80
"c:\Serious Project\Programing Studio 1\terrascope-backend\src\main\java\com\xuanduy\terrascope\repository\StateRepository.java", "Java", 463, 0, 0, 29, 492
"c:\Serious Project\Programing Studio 1\terrascope-backend\src\main\java\com\xuanduy\terrascope\service\CityService.java", "Java", 41, 0, 0, 13, 54
"c:\Serious Project\Programing Studio 1\terrascope-backend\src\main\java\com\xuanduy\terrascope\service\CountryService.java", "Java", 64, 0, 0, 21, 85
"c:\Serious Project\Programing Studio 1\terrascope-backend\src\main\java\com\xuanduy\terrascope\service\GlobalService.java", "Java", 14, 0, 0, 5, 19
"c:\Serious Project\Programing Studio 1\terrascope-backend\src\main\java\com\xuanduy\terrascope\service\StateService.java", "Java", 53, 0, 1, 13, 67
"c:\Serious Project\Programing Studio 1\terrascope-backend\src\main\resources\application.properties", "Java Properties", 0, 2, 0, 1, 3
"c:\Serious Project\Programing Studio 1\terrascope-backend\src\test\java\com\xuanduy\terrascope\TerrascopeApplicationTests.java", "Java", 9, 0, 0, 5, 14
"Total", "-", 3090, 2, 2, 616, 3710