"filename", "language", "JavaScript JSX", "comment", "blank", "total"
"c:\Serious Project\Programing Studio 1\terrascope-frontend\src\components\common\dual-slider-with-inputs\InputField.jsx", "JavaScript JSX", 8, 0, 0, 8
"c:\Serious Project\Programing Studio 1\terrascope-frontend\src\components\common\pagination\PageInput.jsx", "JavaScript JSX", 1, 0, 0, 1
"c:\Serious Project\Programing Studio 1\terrascope-frontend\src\components\common\process-button\ProcessButton.jsx", "JavaScript JSX", 4, 0, 0, 4
"c:\Serious Project\Programing Studio 1\terrascope-frontend\src\pages\deep-dive\find-similar-period\cities\DataDisplay.jsx", "JavaScript JSX", 43, 0, 2, 45
"c:\Serious Project\Programing Studio 1\terrascope-frontend\src\pages\deep-dive\find-similar-period\cities\DataInformation.jsx", "JavaScript JSX", 61, 0, 1, 62
"c:\Serious Project\Programing Studio 1\terrascope-frontend\src\pages\deep-dive\find-similar-period\cities\Header.jsx", "JavaScript JSX", 30, 0, 1, 31
"c:\Serious Project\Programing Studio 1\terrascope-frontend\src\pages\deep-dive\find-similar-period\cities\SimilarPeriodCities.jsx", "JavaScript JSX", 67, 0, 2, 69
"c:\Serious Project\Programing Studio 1\terrascope-frontend\src\pages\deep-dive\find-similar-period\states\SimilarPeriodStates.jsx", "JavaScript JSX", 166, 0, 6, 172
"c:\Serious Project\Programing Studio 1\terrascope-frontend\src\pages\deep-dive\temperature-change-over-periods\cities\TemperatureChangeOverPeriodsCity.jsx", "JavaScript JSX", 0, 0, 1, 1
"c:\Serious Project\Programing Studio 1\terrascope-frontend\src\pages\deep-dive\temperature-change-over-periods\countries\Header.jsx", "JavaScript JSX", 20, 0, 1, 21
"c:\Serious Project\Programing Studio 1\terrascope-frontend\src\pages\deep-dive\temperature-change-over-periods\countries\TemperatureChangeDisplay.jsx", "JavaScript JSX", 40, 0, 3, 43
"c:\Serious Project\Programing Studio 1\terrascope-frontend\src\pages\deep-dive\temperature-change-over-periods\countries\TemperatureChangeOverPeriodsCountries.jsx", "JavaScript JSX", 40, 0, 2, 42
"c:\Serious Project\Programing Studio 1\terrascope-frontend\src\pages\deep-dive\temperature-change-over-periods\countries\TemperatureChangeWithInPeriod.jsx", "JavaScript JSX", 46, 0, 4, 50
"c:\Serious Project\Programing Studio 1\terrascope-frontend\src\pages\deep-dive\temperature-change-over-periods\countries\TemperatureInformation.jsx", "JavaScript JSX", 45, 0, 1, 46
"Total", "-", 571, 0, 24, 595